000000000000000000000
011111111011101111110
010010001011001100010
011011111011111111110
011001001010000001000
011111111010011111110
000011101111111111110
011111101111010101010
011010001101011111110
000111111100011111110
001101110101110101010
001001001101011111110
011101110101011111110
011111110111001000000
010001010111111111110
011111110100110010010
010110110110110110110
010010110010110110110
011111111111110111110
011111111111111111100
000000000000000000000
suka