33333333333333333333
34444444434443444444
34334333434433443334
34434444434444444444
34433433434333333433
34444444434334444444
33334443444444444444
34444443444434343434
64434333443434444445
33344444443334444444
33443444343444343434
33433433443434444444
34443444343434444444
34444444344433433333
34333434344444444444
34444444343344334334
34344344344344344344
34334344334344344344
34444444444444344444
34444444444444444443
suka